poss_propn	poss-propn.txt
poss_n	poss_noun.txt
massn	noun_without_quant.txt	
comp_n	compound_noun.txt
comp_ing_n	verb_noun_nominalization_compound.txt
v_nom	verb_nominalization.txt
propn	propn.txt
propn_def	propn_def.txt
neg	negation.txt	
modal	modal_verb.txt
causative	causative.txt
pass_v	passive.txt
noun_conj	noun_conjunction.txt
sent_conj	sent_conjunction.txt
reason_conj	reason_conjunction.txt
pred_adj	pred_adj.txt
adj	adj.txt
how_pred_adj	how_pred_adj.txt
card	cardinal.txt
ord	ordinal.txt
please	please.txt
time_adv	time.txt
place_adv	place.txt
manner_adv	adv.txt
while_adv	while.txt
intf	intensifier.txt
day	day_of_week.txt
month	month_of_year.txt
q_quant	q_quantifier.txt
q_det	q_det.txt
polite	polite.txt
